//MAP CONVERTED BY dmm2tgm.py THIS HEADER COMMENT PREVENTS RECONVERSION, DO NOT REMOVE
"a" = (
/turf/template_noop,
/area/template_noop)
"b" = (
/turf/closed/wall/mineral/titanium,
/area/shuttle/arrival)
"c" = (
/obj/machinery/door/airlock/titanium{
	name = "Arrivals Shuttle Airlock"
	},
/turf/open/floor/plating,
/area/shuttle/arrival)
"d" = (
/obj/effect/spawner/structure/window/shuttle,
/turf/open/floor/plating,
/area/shuttle/arrival)
"e" = (
/obj/structure/table,
/obj/item/storage/firstaid/regular{
	pixel_y = 4
	},
/turf/open/floor/mineral/titanium/blue,
/area/shuttle/arrival)
"f" = (
/turf/open/floor/mineral/titanium/blue,
/area/shuttle/arrival)
"g" = (
/obj/machinery/light{
	dir = 1
	},
/obj/structure/sign/poster/official/enlist{
	pixel_y = 32
	},
/turf/open/floor/mineral/titanium/blue,
/area/shuttle/arrival)
"h" = (
/obj/structure/closet/wardrobe/black,
/turf/open/floor/mineral/titanium/blue,
/area/shuttle/arrival)
"i" = (
/obj/structure/closet/wardrobe/mixed,
/turf/open/floor/mineral/titanium/blue,
/area/shuttle/arrival)
"j" = (
/obj/machinery/requests_console{
	department = "Arrival shuttle";
	name = "Arrivals Shuttle console";
	pixel_y = 30
	},
/obj/machinery/light{
	dir = 1
	},
/turf/open/floor/mineral/titanium/blue,
/area/shuttle/arrival)
"k" = (
/obj/structure/shuttle/engine/heater{
	dir = 4
	},
/obj/structure/window/reinforced{
	dir = 8
	},
/turf/open/floor/plating/airless,
/area/shuttle/arrival)
"l" = (
/obj/structure/shuttle/engine/propulsion/burst/right{
	dir = 4
	},
/turf/open/floor/plating/airless,
/area/shuttle/arrival)
"m" = (
/obj/structure/grille,
/obj/structure/window/shuttle,
/obj/machinery/door/poddoor/shutters/preopen{
	id = "arrivy";
	name = "ship shutters"
	},
/turf/open/floor/plating,
/area/shuttle/arrival)
"n" = (
/obj/machinery/door/airlock/titanium{
	name = "Arrivals Shuttle Airlock"
	},
/turf/open/floor/mineral/titanium/blue,
/area/shuttle/arrival)
"o" = (
/turf/open/floor/mineral/titanium,
/area/shuttle/arrival)
"p" = (
/obj/structure/chair/comfy/shuttle{
	dir = 8
	},
/turf/open/floor/mineral/titanium,
/area/shuttle/arrival)
"q" = (
/obj/structure/shuttle/engine/propulsion{
	dir = 4
	},
/obj/docking_port/mobile/arrivals{
	height = 13;
	name = "pubby arrivals shuttle";
	width = 6
	},
/turf/open/floor/plating/airless,
/area/shuttle/arrival)
"r" = (
/obj/machinery/light/small,
/turf/open/floor/mineral/titanium/blue,
/area/shuttle/arrival)
"s" = (
/obj/structure/shuttle/engine/propulsion{
	dir = 4
	},
/turf/open/floor/plating/airless,
/area/shuttle/arrival)
"t" = (
/obj/structure/closet/emcloset,
/obj/item/storage/firstaid/o2,
/obj/item/tank/internals/emergency_oxygen,
/obj/item/clothing/mask/breath,
/turf/open/floor/mineral/titanium/blue,
/area/shuttle/arrival)
"u" = (
/obj/structure/extinguisher_cabinet{
	pixel_y = -29
	},
/obj/machinery/light,
/turf/open/floor/mineral/titanium/blue,
/area/shuttle/arrival)
"v" = (
/obj/item/radio/intercom{
	name = "Station Intercom (General)";
	pixel_y = -29
	},
/obj/machinery/light,
/turf/open/floor/mineral/titanium/blue,
/area/shuttle/arrival)
"w" = (
/obj/structure/shuttle/engine/propulsion/burst/left{
	dir = 4
	},
/turf/open/floor/plating/airless,
/area/shuttle/arrival)

(1,1,1) = {"
a
b
m
m
b
a
"}
(2,1,1) = {"
a
b
f
r
b
a
"}
(3,1,1) = {"
b
b
n
n
b
b
"}
(4,1,1) = {"
b
e
o
o
t
b
"}
(5,1,1) = {"
c
f
p
p
f
c
"}
(6,1,1) = {"
b
g
o
o
u
b
"}
(7,1,1) = {"
d
h
p
p
f
d
"}
(8,1,1) = {"
d
i
o
o
f
d
"}
(9,1,1) = {"
d
f
p
p
f
d
"}
(10,1,1) = {"
b
j
p
p
v
b
"}
(11,1,1) = {"
c
f
o
o
f
c
"}
(12,1,1) = {"
b
k
k
k
k
b
"}
(13,1,1) = {"
b
l
q
s
w
b
"}
